28 28
|--------------------------|
|                          |
|       ##########         |
|      #         #         |
|       #        #         |
|        #        #        |
|         #     @#         |
|          #     @#        |
|           #     @#       |
|            #     @#      |
|             #   # @####  |
|                @#        |
|           @@@@@@#        |
|                @#        |
|              #  ####     |
|             #      #     |
|            #       #     |
|           #        #     |
|         #          #     |
|         #          #     |
|         #         #      |
|         #        #       |
|        #        #        |
|       #        #         |
|      #        #          |
|      #       #           |
|       #######            |
|--------------------------|
